NO ./textures/sq.xpm
WE ./textures/door.xpm
EA ./textures/glass.xpm
SO ./textures/logement.xpm

C 119	,	181	,	254
F 1, 67, 37

11111111111111111111111111111111111111111111111111111111111111111111111111111111111111111111111111111111111111111111111111111111111
101010101011111110001
100000000000000010001
110000000000000011101
100000000000000000001
100000000000000111111
100000000000000000101
100000000000000110101
100000000000000010101
100000000000000010101
100000000000000010001
110000000000000011101
100000000000000010001
100000000000000110111
100000000000000010101
100000000000000010101
100000000000000010001
100000000000000111101
1N1000001000000000001
111111111111111111111